0 0 0 0 0 0 0 0 0 0 0 0 0 0 0 0 0 0 0 0 0 0 0 0 0 0 0 0 0 0 0 0
0 0 2 2 2 2 2 0 0 0 0 2 0 0 2 2 2 2 4 2 5 2 2 2 2 2 2 0 0 0 0 0
0 0 2 0 0 2 0 0 0 0 0 2 0 0 0 0 0 0 0 0 0 0 2 0 0 0 2 0 0 0 0 0
0 0 2 0 0 2 0 0 0 0 0 4 0 0 0 0 0 0 0 0 0 0 0 0 0 0 2 0 0 0 0 0
0 0 2 0 0 2 0 0 0 0 0 3 0 0 0 2 2 0 0 0 0 0 0 0 0 0 9 0 0 0 2 2
0 0 0 0 0 0 0 0 0 0 0 2 0 0 0 2 2 0 0 0 2 0 0 0 0 0 2 0 0 0 2 0
0 0 2 2 8 2 2 2 2 2 2 2 0 0 0 2 2 0 0 0 2 0 0 0 0 0 2 0 0 0 0 0
0 0 0 0 0 0 0 0 0 0 0 0 0 0 0 0 0 0 0 0 2 2 0 0 0 0 2 0 0 0 0 0
0 0 2 0 0 0 0 2 2 0 0 0 0 0 0 0 0 0 0 0 2 0 0 0 0 0 2 0 0 0 3 3
0 0 2 0 0 0 0 2 2 0 0 0 0 0 0 0 0 0 0 0 2 0 0 0 0 0 0 0 0 0 0 0
0 0 2 0 0 0 0 0 0 0 0 0 0 0 0 0 0 1 2 2 2 0 0 0 0 0 0 0 0 0 0 0
0 0 2 2 2 2 2 3 3 3 5 0 0 0 0 0 0 1 0 0 0 0 0 0 0 0 0 0 0 0 0 0
0 0 0 0 0 0 0 0 0 0 0 0 0 0 0 0 0 1 0 0 0 0 0 0 3 0 0 3 3 3 0 3
0 0 2 0 0 0 0 0 0 0 0 2 2 2 2 0 0 1 0 0 0 0 0 0 5 0 0 0 3 0 0 0
0 0 2 0 0 0 0 2 2 0 0 2 0 0 0 0 0 0 0 0 0 0 0 0 3 0 0 0 3 0 0 0
0 0 2 0 0 0 0 2 0 0 0 2 0 0 0 0 0 0 0 0 0 0 0 0 3 0 0 0 3 0 0 0
0 0 2 2 2 2 4 2 2 2 2 2 0 0 3 3 0 3 3 5 3 3 3 3 3 0 0 0 8 0 0 0
2 0 0 0 0 0 0 0 0 0 0 0 0 0 0 3 0 0 0 0 0 0 3 0 0 0 0 0 3 0 0 0
0 0 0 0 0 0 0 0 0 0 0 0 0 0 0 3 0 0 0 0 0 0 0 0 0 0 0 0 3 0 0 0
0 0 2 7 2 2 2 2 2 2 0 0 0 0 0 3 0 0 3 0 0 0 0 0 0 0 0 0 3 0 0 0
0 0 0 0 0 0 0 0 0 2 0 0 0 0 0 3 3 3 3 5 3 3 3 3 3 0 3 3 3 0 0 0
2 2 0 0 0 2 0 0 0 2 0 0 3 0 0 3 0 0 0 2 0 0 0 0 0 0 0 0 0 0 0 0
0 0 0 2 2 2 0 0 0 2 0 0 3 3 5 3 0 0 0 2 0 0 0 0 0 0 0 0 0 0 0 0
0 0 0 2 0 0 0 0 0 2 0 0 0 0 0 0 0 0 0 2 0 0 0 0 0 0 0 0 0 0 0 0
0 0 0 2 0 0 0 0 0 2 0 0 0 0 0 0 0 0 0 2 0 0 0 0 3 3 3 3 0 3 3 3
0 0 0 2 6 2 2 2 7 2 0 0 0 0 0 0 0 0 0 2 0 0 0 0 3 0 0 0 0 0 0 0
0 0 0 0 2 0 0 0 0 0 0 0 0 0 2 2 4 2 2 2 0 0 0 0 3 0 0 0 0 0 0 0
0 0 0 0 2 0 0 0 0 0 0 0 0 0 0 0 0 0 0 0 0 0 0 0 0 0 0 0 2 0 0 0
0 0 0 0 0 0 0 0 0 0 0 2 0 0 0 0 0 0 0 0 0 0 0 0 3 0 0 0 2 0 0 0
0 0 0 0 2 0 0 0 0 0 0 2 0 0 0 0 0 2 0 0 0 0 0 0 3 0 0 0 2 0 0 0